WWWWWWWWWWWWWWW
WP  RYBBB BBBBW
W W W W W W W W
W         B B W
WBW W W W WBW W
W          B  W
W W W W W W W W
WB   B   B    W
WBW W W WBW W W
W     BB   B BW
W WBW W W W W W
W        B   GW
WWWWWWWWWWWWWWW